@@@@@
@...@
@...@
@...@
@@@@@
# @@@@@@
# @....@
# @.@..@
# @..@.@
# @....@
# @@@@@@